6 14 14 14 14 14 14 5 14 14 14 14 14 14 14 6
11 0 0 0 0 0 0 5 0 0 0 0 0 0 0 10
11 0 0 0 0 0 0 5 0 0 1 0 0 0 0 10
11 0 1 0 0 0 0 5 0 0 0 0 1 0 0 10
11 0 0 0 0 0 0 5 5 5 0 0 0 0 0 10
11 0 0 0 0 0 0 0 0 5 0 0 0 0 0 10
11 0 0 0 0 0 0 0 0 5 5 5 5 5 5 5 
11 0 0 1 0 0 0 0 0 0 0 0 0 0 0 10 
11 0 0 0 0 0 0 0 0 0 4 4 3 0 4 10
11 0 0 0 0 0 0 0 0 0 0 3 3 4 3 10
11 0 0 0 1 0 0 0 0 0 0 0 3 3 3 10
6 8 8 8 8 8 8 8 8 8 8 8 8 8 8 6
