00 00 24 00 00 00 03 00 00 00 03 00 01 00 00 00
00 03 03 03 03 03 03 03 03 03 03 03 03 03 03 00
00 03 03 24 03 03 03 03 03 03 01 03 26 03 03 00
00 03 01 03 03 03 03 21 03 03 21 24 24 03 03 01
01 03 03 24 21 03 03 03 03 03 23 03 03 23 03 10
00 03 03 03 26 03 03 03 03 03 03 03 03 03 03 10
05 05 05 05 05 05 05 07 05 05 05 05 25 26 24 01
00 25 03 01 03 03 03 06 03 02 03 03 03 26 03 02
00 03 03 03 21 03 24 06 03 03 21 04 00 21 04 02
00 03 24 03 25 03 03 23 05 05 05 05 26 04 24 10
00 03 03 03 01 03 03 21 03 21 21 03 00 21 24 10
01 08 08 06 01 08 02 02 01 02 01 02 02 03 03 02