08 09 09 09 09 09 09 06 09 09 09 09 09 09 09 10
11 04 00 00 01 20 00 06 00 00 27 00 00 00 00 11
11 00 14 15 00 23 04 06 00 00 01 18 19 00 00 11
11 00 16 17 01 00 00 06 00 00 00 01 18 20 22 11
11 00 01 05 05 05 05 07 01 00 00 00 00 01 00 11
11 00 00 00 18 19 20 06 00 00 18 19 20 27 00 11
11 27 00 00 00 00 00 07 05 05 05 05 05 05 05 05
11 00 19 00 20 00 00 06 00 00 22 21 00 00 00 11
11 04 00 00 20 00 00 06 00 00 00 00 20 00 00 11
11 00 19 19 05 05 05 07 00 00 00 21 00 19 18 11
11 00 00 00 01 01 23 06 00 27 00 00 04 00 01 11
13 09 09 09 09 09 09 09 09 09 09 09 09 09 09 12