06 14 14 14 14 14 14 14 14 14 14 14 14 14 14 06
11 03 03 03 03 03 03 03 03 03 03 03 03 03 03 10
11 03 03 03 03 03 03 03 03 03 01 03 03 03 03 10
11 03 01 03 03 03 03 03 03 03 03 03 01 03 03 10
11 03 03 03 03 03 03 03 03 03 03 03 03 03 03 10
11 03 03 03 03 03 03 03 03 03 03 03 03 03 03 10
11 03 03 03 03 03 03 03 03 03 05 05 05 05 05 05
11 03 03 01 03 03 03 03 03 03 03 03 03 03 03 10
11 03 03 03 03 03 03 03 03 03 04 04 00 04 04 10
11 03 03 03 03 03 03 03 03 03 03 00 00 04 00 10
11 03 03 03 01 03 03 03 03 03 03 03 00 00 00 10
06 08 08 08 08 08 08 08 08 08 08 08 08 08 08 06