08 09 09 09 09 09 09 06 09 09 09 09 09 09 09 10
11 03 03 03 03 03 03 06 00 00 00 00 03 00 03 11
11 03 04 00 27 03 19 06 00 00 00 18 19 00 00 11
11 03 01 03 03 03 03 06 00 00 03 00 01 00 00 11
11 14 15 03 03 00 00 06 00 00 00 18 19 03 18 11
11 16 17 03 03 00 01 06 00 00 00 00 03 03 00 11
11 05 05 05 05 05 05 07 05 05 05 05 05 05 05 05
11 00 00 00 00 00 00 06 00 00 00 00 00 00 03 11
11 00 00 00 03 00 01 06 00 00 00 00 00 00 00 11
11 27 04 18 00 00 00 06 00 00 00 18 00 18 27 11
11 00 04 04 01 00 00 06 00 00 00 00 00 19 18 11
13 09 09 09 09 09 09 09 09 09 09 09 09 09 09 12
