03 02 03 03 00 02 02 00 00 22 02 01 00 00 00 02
00 23 00 00 00 00 00 01 00 00 00 00 04 22 00 00
03 03 00 23 03 04 03 00 00 00 23 07 05 05 05 05
00 00 00 00 00 03 00 00 00 00 00 06 00 00 00 02
02 00 03 22 00 00 00 01 00 00 21 06 00 04 00 00
01 00 00 00 00 04 00 06 00 00 00 06 00 00 22 02
02 05 05 05 05 05 05 07 05 05 05 07 00 00 04 01
03 00 25 26 00 00 04 06 00 00 25 04 00 00 02 04
01 00 00 00 00 00 00 06 00 00 00 00 02 03 02 02
00 00 00 00 23 24 00 06 02 00 23 24 02 00 03 04
00 00 24 00 00 00 00 06 00 00 00 00 03 02 25 00
02 03 00 02 04 02 00 06 25 01 00 00 03 03 03 12