03 23 04 04 00 02 02 00 00 00 02 04 00 00 00 04
03 24 00 03 04 04 02 03 00 02 04 04 02 00 03 02
00 02 03 04 02 03 03 00 00 00 02 03 00 02 02 02
03 03 04 03 00 02 02 00 00 03 02 01 02 00 00 02
03 22 00 02 04 04 03 00 03 00 03 02 00 04 04 02
02 02 03 02 02 04 02 06 00 03 02 04 00 04 04 03
04 03 02 03 00 04 02 06 00 02 02 03 02 00 03 04
03 02 02 04 03 02 03 06 00 02 02 04 00 02 00 02
03 00 03 04 00 02 02 06 00 03 03 03 04 00 04 02
03 02 03 03 02 03 02 06 03 04 02 03 00 04 00 02
03 04 03 03 03 02 02 06 00 03 02 03 02 02 02 04
03 03 02 03 00 02 02 06 00 03 02 00 00 00 03 02
