06 14 14 14 14 14 14 15 14 14 14 14 14 14 14 06
11 03 03 03 03 03 03 15 03 03 03 03 03 03 03 10
11 03 04 00 03 03 03 15 03 03 01 03 03 03 03 10
11 03 01 03 03 03 03 15 03 03 03 03 01 03 03 10
11 03 03 03 03 05 05 05 05 05 03 03 00 03 03 10
11 03 03 03 03 05 01 00 00 05 03 03 03 03 03 10
05 05 05 05 05 05 00 01 00 05 05 05 05 05 05 05
11 03 03 00 03 05 05 05 05 05 03 03 03 03 03 10
11 03 03 03 03 03 01 15 03 03 04 04 00 04 04 10
11 03 04 03 03 03 03 15 03 03 03 00 00 04 00 10
11 03 04 04 01 03 03 15 03 03 03 03 00 00 00 10
06 08 08 08 08 08 08 15 08 08 08 08 08 08 08 06
